R 720 480
NO ./textures/128.xpm
EA ./textures/128.xpm
SO ./textures/128.xpm
WE ./textures/128.xpm
S ./textures/ghost.xpm
C 100,100,120
F 30,30,62

        1111111111111111111111111
        1000000000110000000000001
        1011000001110000002000001
        1001000000000000000000001
111111111011000001110000000000001
100000000011000001110111111111111
11110111111111011100000010001
11110111111111010101010010001
11000000110101011100000012001
10002000000000001100000000001
10000000000000001101010010001
11000001110101011111011110N0111
11110111 1110101 101111010001
11111111 1111111 111111111111